
						                        		      
BF                                     oo2o                                                   EB
AD                                     IIII                                                 * CA
AD                              oooo         oooo                                  III     II CA
AD                              IIII         IIII                          III                CA
AD                       oooo                      oooo              oooo                II   CA
AD                ooo 2  IIII    2              2  IIII   oooo 2     IIII      2              CA
AD          2     III      2             2         2      IIII      1      2     2    II      CA
AD          II                        II     II                    II            II           CA
AD    1     II     1    1     1       II  1  II   1  2   1        1     1       1             CA
AHBBBBBBBBBBBBBBBBBBBBBBBBBBBBBBBBBBGAAAAAAAAAAAAAAAHBBBBBBBBBBBBBBBBBBBBBBBBBBBBBBBBBBBBBBBBBGA